12 12 4 3
@.+++#++++.@
.#+#++++#+#.
++++#+#+#+++
+##+++++++#+
++++##+#+#++
++#++++#+++#
#+++#++++#++
++#+#+##++++
+#+++++++##+
+++#+#+#++++
.#+#++++#+#.
@.++++#+++.@